NO ./textures/NO.jpg
SO ./textures/SO.jpg
WE ./textures/WE.jpg
EA ./textures/EA.jpg

F 0,255,1
C 0,100,255

11111111
10000001
10000001
10011001
10011001
10000001
1000N001
11111111
